24 30
28 28 28 28 28 28 28 301 28 28 28 28 28 111 112 112 112 112 112 112 112 113 28 28
28 28 28 28 28 28 302 305 308 28 28 28 28 114 115 115 115 115 115 115 115 116 28 28
28 28 283 286 289 28 303 306 309 28 28 28 28 114 115 115 115 115 115 115 115 116 28 28
33 28 284 287 290 28 304 307 310 28 311 314 317 114 115 115 115 115 115 115 115 116 28 28
28 28 285 288 291 28 320 321 322 28 312 315 318 114 115 115 115 115 115 115 115 116 28 28
28 28 323 324 325 28 326 327 328 28 313 316 319 114 115 115 115 115 115 115 115 116 35 28
34 28 329 330 331 28 28 28 28 28 320 321 322 114 115 115 115 115 115 115 115 116 28 28
28 28 28 28 28 28 33 28 28 28 326 327 328 114 115 115 115 115 115 115 115 116 28 33
28 28 35 28 28 28 28 28 34 35 28 28 28 117 118 118 118 118 118 118 118 119 28 28
28 28 28 28 34 28 28 28 28 28 28 28 28 28 28 28 35 28 28 28 28 28 28 28
28 34 28 28 28 28 28 28 129 130 130 130 130 131 28 147 142 142 142 142 142 142 142 149
28 28 28 28 246 247 28 28 132 133 133 133 133 134 35 145 28 28 28 28 28 28 105 145
28 34 33 28 251 252 28 28 132 133 133 133 133 134 34 145 28 28 28 28 28 28 108 145
28 28 28 28 28 214 216 28 132 133 133 133 133 134 28 145 28 28 28 28 28 28 28 145
28 28 28 35 28 215 217 28 132 133 133 133 133 134 28 145 28 28 28 28 28 28 105 145
28 28 28 243 254 255 28 28 132 133 133 133 133 134 28 145 28 28 28 28 28 28 108 145
28 35 28 248 259 28 28 28 132 133 133 133 133 134 28 145 28 28 28 28 28 28 28 145
28 33 28 28 28 28 28 33 135 136 136 136 136 137 35 153 142 142 142 156 142 142 142 155
28 28 28 28 28 35 28 28 28 28 28 28 28 28 28 28 28 28 28 28 28 28 28 28
7 7 7 7 7 7 7 7 7 7 7 7 7 7 7 7 7 7 7 7 7 8 35 28
17 17 17 17 17 17 17 17 17 17 17 17 17 17 17 17 17 10 10 10 10 11 28 28
17 17 17 17 17 17 17 17 17 17 17 17 17 17 17 17 17 17 17 17 17 11 28 33
13 13 13 13 13 13 13 13 13 13 13 13 13 13 13 13 13 13 13 2 17 11 28 34
28 28 28 33 28 28 28 28 28 28 28 35 34 35 28 28 28 28 28 9 17 11 28 28
43 43 43 43 43 43 43 43 43 43 43 43 43 43 43 43 44 34 28 9 17 11 28 28
46 46 46 46 46 46 46 46 46 46 46 165 46 46 165 46 47 28 28 9 17 11 28 28
46 46 46 46 46 46 46 46 165 46 46 181 46 46 173 46 47 28 28 9 17 11 28 28
46 37 49 38 46 46 46 46 181 46 46 46 46 46 181 46 47 33 28 9 10 11 35 28
46 47 35 45 46 46 46 46 46 46 46 46 46 46 46 46 47 28 35 9 10 11 34 28
46 47 35 48 38 46 46 46 46 46 46 46 46 46 46 46 47 28 28 9 17 11 28 28