18 16
28 -1 -1 28 -1 -1 28 -1 -1 28 -1 -1 28 -1 -1 28 -1 -1 28 -1 -1 28 -1 -1 28 -1 -1 28 -1 -1 28 -1 -1 28 -1 -1 28 -1 -1 28 -1 -1 28 -1 -1 28 -1 -1 28 -1 -1 28 -1 -1 
28 -1 -1 28 -1 -1 28 -1 -1 28 -1 -1 28 -1 -1 28 -1 -1 28 -1 -1 28 -1 -1 28 -1 -1 28 -1 -1 28 -1 -1 28 -1 -1 28 -1 -1 28 -1 -1 28 -1 -1 28 -1 -1 28 -1 -1 28 -1 -1 
28 -1 -1 28 -1 -1 28 -1 -1 28 -1 -1 28 -1 -1 28 -1 -1 28 -1 -1 28 -1 -1 28 -1 -1 28 -1 -1 28 -1 -1 28 -1 -1 28 -1 -1 28 -1 -1 28 -1 -1 28 -1 -1 28 -1 -1 28 -1 -1 
28 -1 -1 28 -1 -1 28 -1 -1 28 -1 -1 28 -1 -1 28 -1 -1 28 -1 -1 28 -1 -1 28 -1 -1 28 -1 -1 28 -1 -1 28 -1 -1 28 -1 -1 28 -1 -1 28 -1 -1 28 -1 -1 28 -1 -1 28 -1 -1 
28 -1 -1 28 -1 -1 28 -1 -1 28 -1 -1 28 -1 -1 28 -1 -1 28 -1 -1 28 -1 -1 28 -1 -1 28 -1 -1 28 -1 -1 28 -1 -1 28 -1 -1 28 -1 -1 28 -1 -1 28 -1 -1 28 -1 -1 28 -1 -1 
28 -1 -1 28 -1 -1 28 -1 -1 28 -1 -1 28 -1 -1 28 -1 -1 28 -1 -1 28 -1 -1 28 -1 -1 28 -1 -1 28 -1 -1 28 -1 -1 28 -1 -1 28 -1 -1 28 -1 -1 28 -1 -1 28 -1 -1 28 -1 -1 
28 -1 -1 28 -1 -1 28 -1 -1 28 -1 -1 28 -1 -1 28 -1 -1 28 -1 -1 28 -1 -1 28 -1 -1 28 -1 -1 28 -1 -1 28 -1 -1 28 -1 -1 28 -1 -1 28 -1 -1 28 -1 -1 28 -1 -1 28 -1 -1 
28 -1 -1 28 -1 -1 28 -1 -1 28 -1 -1 28 -1 -1 28 -1 -1 28 -1 -1 28 -1 -1 28 -1 -1 28 -1 -1 28 -1 -1 28 -1 -1 28 -1 -1 28 -1 -1 28 -1 -1 28 -1 -1 28 -1 -1 28 -1 -1 
28 -1 -1 28 -1 -1 28 -1 -1 28 -1 -1 28 -1 -1 28 -1 -1 28 -1 -1 28 -1 -1 28 -1 -1 28 -1 -1 28 -1 -1 28 -1 -1 28 -1 332 28 -1 348 28 -1 349 28 -1 350 28 -1 334 28 -1 -1 
28 -1 -1 28 -1 -1 28 -1 -1 28 -1 -1 28 -1 -1 28 -1 -1 28 -1 -1 28 -1 -1 28 -1 -1 28 -1 -1 28 -1 -1 28 -1 -1 28 -1 335 28 -1 352 28 -1 353 369 -1 354 28 -1 337 28 -1 -1 
28 -1 -1 28 -1 -1 28 -1 -1 28 -1 -1 28 -1 -1 28 -1 -1 28 -1 -1 28 -1 -1 28 -1 -1 28 -1 -1 28 -1 -1 28 -1 -1 28 -1 338 28 -1 339 28 -1 339 28 -1 339 28 -1 340 28 -1 -1 
28 -1 -1 28 -1 -1 28 -1 -1 28 -1 -1 28 -1 -1 28 -1 -1 28 -1 -1 28 -1 -1 28 -1 -1 28 -1 -1 28 -1 -1 28 -1 -1 102 360 -1 361 -1 -1 361 -1 -1 361 372 -1 102 362 -1 28 -1 -1 
28 -1 -1 28 -1 -1 28 -1 -1 28 -1 -1 28 -1 -1 28 -1 -1 28 -1 -1 28 -1 -1 28 -1 -1 28 -1 -1 28 -1 -1 28 -1 -1 102 363 -1 374 -1 -1 28 364 -1 364 373 -1 102 365 -1 28 -1 -1 
28 -1 -1 28 -1 -1 28 -1 -1 28 -1 -1 28 -1 -1 28 -1 -1 28 -1 -1 28 -1 -1 28 -1 -1 28 -1 -1 28 -1 -1 28 -1 -1 28 366 -1 375 370 -1 367 -1 -1 367 -1 -1 28 368 -1 28 -1 -1 
28 -1 -1 28 -1 -1 28 -1 -1 28 -1 -1 28 -1 -1 28 -1 -1 28 -1 -1 28 -1 -1 28 -1 -1 28 -1 -1 28 6 -1 28 7 -1 28 5 -1 17 371 -1 17 -1 -1 17 -1 -1 28 4 -1 28 7 -1 
28 -1 -1 28 -1 -1 28 -1 -1 28 -1 -1 28 -1 -1 28 -1 -1 28 -1 -1 28 -1 -1 28 -1 -1 28 -1 -1 28 9 -1 28 10 -1 28 10 -1 28 10 -1 28 10 -1 28 10 -1 28 10 -1 28 10 -1 
