24 30
0 0 0 0 0 0 0 0 0 0 0 0 0 0 0 0 0 0 0 0 0 0 0 0
0 0 0 0 0 8 8 8 0 0 0 0 0 0 0 0 0 18 19 0 0 0 15 0
0 8 8 8 0 8 8 8 0 0 0 0 0 0 0 0 18 17 17 19 0 0 0 0
0 8 8 8 0 0 7 0 0 0 0 0 0 0 0 0 16 16 16 16 0 0 0 0
0 0 7 0 0 0 12 0 0 0 9 9 9 0 0 14 16 22 16 16 1 0 0 0
0 0 4 0 0 0 0 0 0 0 9 9 9 0 0 14 14 14 14 14 14 0 0 0
0 0 12 0 0 0 0 0 0 0 0 0 0 0 0 0 0 0 0 0 0 0 0 0
0 0 0 0 0 0 0 0 8 8 8 0 0 0 0 0 0 0 0 0 8 8 8 0
0 0 0 0 0 0 0 0 8 8 8 0 0 0 8 8 8 0 0 0 8 8 8 0
0 0 0 0 0 0 0 0 0 7 0 0 0 8 8 8 8 8 0 0 0 7 0 0
0 0 0 8 8 0 0 0 0 12 0 0 0 8 8 8 8 8 0 0 0 12 0 0
0 0 8 8 8 8 0 0 0 0 0 0 0 0 0 7 0 0 0 0 0 0 0 0
0 0 8 8 8 8 0 0 0 0 3 0 0 0 0 7 11 6 0 0 0 0 0 0
0 0 0 7 7 0 0 0 0 0 0 0 0 0 0 7 0 0 0 0 0 0 10 0
0 0 0 12 12 0 0 8 8 8 0 0 0 0 0 12 0 0 0 0 0 0 0 0
0 0 0 0 0 0 0 8 8 8 0 0 0 0 0 0 0 0 0 0 0 0 0 0
0 0 0 0 0 0 0 0 7 0 0 0 0 0 0 0 18 17 17 17 19 0 0 0
0 8 8 8 0 0 0 0 7 0 0 0 13 0 0 0 16 16 16 16 16 0 0 0
0 8 8 8 0 0 0 0 12 0 0 0 0 0 0 0 16 16 16 21 16 0 0 0
0 0 7 0 0 0 15 0 0 0 0 0 0 0 0 14 16 22 16 16 16 1 0 0
0 0 12 0 0 0 0 0 0 0 0 0 0 0 0 14 14 14 14 14 14 14 0 0
0 0 0 0 0 0 0 0 8 8 8 0 0 0 0 14 14 14 14 14 14 14 0 0
0 0 0 0 0 0 0 0 8 8 8 0 0 0 0 0 0 0 0 0 0 0 0 0
0 0 18 17 17 17 19 0 0 7 0 0 8 8 8 0 0 0 0 0 0 0 3 0
0 0 16 16 16 16 16 0 0 12 0 0 8 8 8 0 0 10 10 10 0 0 0 0
0 0 16 20 16 21 16 0 0 0 0 0 0 7 0 0 0 10 10 10 0 0 0 0
0 14 16 16 22 16 16 1 0 0 0 0 0 12 0 0 0 0 0 0 0 0 0 0
0 14 14 14 14 14 14 14 0 0 0 0 0 0 0 0 0 0 0 0 0 0 0 0
2 2 2 2 2 2 2 2 2 2 2 2 2 2 2 2 2 2 2 2 2 2 2 2
23 23 23 23 23 23 23 23 23 23 23 23 23 23 23 23 23 23 23 23 23 23 23 23