26 30
16 28 -1 28 -1 -1 28 34 -1 28 -1 291 16 28 294 28 -1 297 28 -1 -1 28 -1 -1 28 -1 -1 102 -1 -1 102 -1 -1 28 -1 -1 28 -1 -1 28 -1 -1 28 -1 -1 28 -1 -1 28 -1 -1 28 -1 -1 28 -1 -1 28 -1 -1 28 -1 -1 28 -1 -1 28 -1 -1 28 -1 -1 28 -1 -1 28 -1 -1 
28 -1 -1 33 -1 -1 28 -1 -1 28 -1 292 16 28 295 28 -1 298 28 -1 -1 28 33 -1 28 -1 -1 102 214 -1 102 216 -1 28 -1 -1 28 -1 332 344 -1 -1 346 -1 -1 28 -1 334 28 -1 -1 28 34 -1 28 -1 -1 28 -1 -1 28 -1 -1 28 -1 -1 28 278 -1 28 -1 -1 28 34 -1 28 -1 -1 
16 28 282 28 -1 285 28 -1 288 28 102 293 102 331 296 28 -1 299 28 -1 -1 28 -1 -1 28 -1 -1 28 215 -1 28 217 -1 28 -1 -1 28 -1 338 28 -1 339 28 -1 339 28 -1 340 28 -1 -1 28 -1 -1 28 -1 -1 28 -1 -1 28 -1 -1 28 -1 -1 28 -1 -1 28 -1 -1 28 34 -1 28 35 -1 
28 -1 283 28 -1 286 28 -1 289 102 322 -1 28 323 -1 28 324 -1 28 -1 -1 28 34 -1 28 -1 -1 28 193 -1 28 194 -1 28 -1 -1 28 360 -1 361 -1 -1 361 -1 -1 28 362 -1 28 -1 -1 28 -1 -1 28 33 -1 28 -1 282 28 -1 285 28 -1 288 28 34 -1 28 -1 -1 28 34 -1 28 -1 -1 
28 -1 284 28 331 287 28 -1 290 102 328 -1 28 329 -1 28 330 -1 28 35 -1 28 -1 -1 28 -1 -1 28 197 -1 28 198 -1 28 -1 -1 28 363 -1 364 378 -1 364 -1 -1 28 365 -1 102 35 -1 28 -1 -1 28 -1 -1 28 -1 283 28 -1 286 28 -1 289 28 -1 -1 28 -1 -1 28 -1 -1 28 -1 -1 
28 322 -1 28 323 -1 28 324 -1 28 -1 -1 28 -1 -1 129 -1 -1 130 279 279 130 279 279 130 279 279 131 -1 -1 28 202 -1 28 -1 -1 28 366 -1 370 379 -1 367 -1 -1 28 368 -1 28 -1 -1 28 -1 -1 28 -1 -1 28 -1 284 28 331 287 28 35 290 28 -1 -1 28 33 -1 28 -1 -1 28 -1 -1 
28 328 -1 28 329 -1 28 330 -1 28 -1 -1 28 35 -1 132 -1 -1 133 273 279 133 273 279 133 273 279 134 -1 -1 28 -1 -1 28 6 -1 28 5 -1 17 371 -1 17 -1 -1 28 4 -1 28 8 -1 28 34 -1 28 -1 -1 28 -1 -1 28 331 -1 28 -1 -1 28 -1 -1 28 -1 -1 28 -1 -1 28 35 -1 
28 35 -1 28 -1 -1 28 -1 -1 28 33 -1 28 -1 -1 132 -1 -1 133 273 -1 133 273 -1 133 273 -1 134 -1 -1 28 -1 -1 28 12 -1 28 13 -1 28 13 291 28 13 294 28 13 297 28 14 -1 28 -1 -1 28 -1 -1 28 322 -1 28 323 -1 28 324 -1 28 33 -1 28 -1 -1 28 -1 -1 28 -1 -1 
28 -1 -1 28 -1 -1 28 -1 -1 28 34 -1 28 -1 -1 135 -1 -1 136 -1 -1 136 -1 -1 136 -1 -1 137 -1 -1 28 35 -1 28 -1 -1 28 -1 -1 102 -1 292 28 -1 295 28 -1 298 28 -1 -1 28 -1 -1 28 -1 -1 28 328 -1 102 329 -1 28 330 -1 28 35 -1 28 -1 -1 28 -1 -1 28 -1 -1 
28 -1 -1 28 33 -1 28 -1 -1 28 -1 -1 28 -1 -1 28 -1 -1 28 -1 -1 28 -1 -1 28 -1 -1 28 -1 -1 28 -1 -1 28 -1 -1 28 -1 -1 28 -1 293 28 331 296 28 -1 299 28 -1 -1 28 -1 -1 28 -1 -1 28 34 -1 28 -1 -1 28 -1 -1 28 -1 -1 28 -1 -1 28 -1 -1 28 -1 -1 
28 -1 -1 28 -1 -1 28 -1 291 28 -1 294 28 35 297 28 -1 -1 28 33 -1 28 -1 -1 28 -1 -1 28 34 -1 28 -1 -1 28 33 -1 28 -1 -1 28 -1 -1 28 331 -1 28 -1 -1 28 34 -1 28 -1 -1 28 -1 -1 28 -1 -1 28 -1 -1 28 278 -1 28 -1 -1 28 -1 -1 28 -1 -1 28 33 -1 
28 35 -1 28 -1 -1 28 -1 292 28 -1 295 28 -1 298 28 -1 -1 28 -1 -1 28 -1 -1 28 -1 -1 28 -1 -1 28 -1 -1 28 -1 -1 28 -1 -1 28 322 -1 28 323 -1 28 324 -1 28 -1 -1 28 -1 -1 28 33 -1 28 -1 -1 28 -1 -1 28 -1 -1 28 35 -1 28 -1 -1 28 -1 -1 28 -1 -1 
28 -1 -1 28 34 -1 28 -1 293 28 331 296 28 -1 299 28 34 -1 28 -1 -1 28 -1 -1 28 33 -1 28 -1 -1 28 -1 -1 28 -1 -1 28 -1 -1 28 328 -1 28 329 -1 28 330 -1 28 -1 -1 28 -1 -1 28 -1 -1 28 -1 -1 28 -1 -1 28 34 -1 28 -1 -1 28 -1 -1 28 33 -1 28 -1 -1 
28 -1 -1 28 -1 -1 28 322 -1 28 323 -1 28 324 -1 28 -1 -1 28 -1 -1 28 -1 -1 28 -1 -1 28 -1 -1 28 -1 -1 28 34 -1 28 -1 -1 28 -1 -1 28 -1 -1 28 -1 -1 28 -1 332 348 -1 -1 349 -1 -1 350 347 -1 28 -1 334 28 -1 -1 28 -1 -1 28 -1 -1 28 -1 -1 28 -1 -1 
28 33 -1 28 -1 -1 28 328 -1 28 329 -1 28 330 -1 28 33 -1 28 -1 -1 28 -1 -1 28 -1 -1 28 -1 -1 28 -1 -1 28 -1 -1 28 34 -1 28 -1 -1 28 33 -1 28 -1 -1 28 -1 335 352 -1 -1 353 -1 -1 354 369 -1 28 -1 337 28 -1 -1 28 -1 -1 28 33 -1 28 -1 -1 28 -1 -1 
28 -1 -1 28 -1 -1 28 35 -1 28 -1 -1 28 -1 -1 28 -1 -1 28 -1 -1 28 -1 282 28 -1 285 28 -1 288 28 -1 -1 28 -1 -1 28 -1 -1 28 -1 -1 28 -1 -1 28 -1 -1 28 -1 338 28 -1 339 28 -1 339 28 -1 339 28 -1 340 28 -1 -1 28 34 -1 28 -1 -1 28 -1 -1 28 -1 -1 
28 -1 -1 28 -1 282 28 -1 285 28 -1 288 28 -1 -1 28 -1 -1 28 35 -1 28 -1 283 28 331 286 28 -1 289 28 35 -1 28 -1 -1 28 122 -1 28 -1 -1 28 35 -1 28 -1 -1 28 360 -1 361 -1 -1 361 -1 -1 361 372 -1 28 362 -1 28 -1 -1 28 -1 -1 28 35 -1 28 -1 -1 28 -1 -1 
28 -1 -1 28 -1 283 28 -1 286 28 -1 289 28 34 -1 28 -1 -1 28 -1 -1 28 322 284 28 323 287 28 324 290 28 -1 -1 28 -1 -1 28 -1 -1 28 -1 -1 28 -1 -1 28 -1 -1 28 363 -1 364 378 -1 364 -1 -1 364 373 -1 28 365 -1 28 -1 -1 28 235 -1 28 236 -1 28 -1 -1 28 35 -1 
28 -1 -1 28 -1 284 28 331 287 28 -1 290 28 -1 -1 28 -1 -1 28 278 -1 28 328 -1 28 329 -1 28 330 -1 28 -1 -1 28 -1 -1 28 35 -1 28 -1 -1 28 -1 -1 28 205 -1 28 366 -1 379 370 -1 17 367 -1 17 367 -1 28 368 -1 17 28 -1 28 241 -1 28 242 -1 28 -1 -1 28 -1 -1 
28 -1 -1 28 322 -1 28 323 -1 28 324 -1 28 -1 -1 28 -1 -1 28 -1 -1 28 -1 -1 28 -1 -1 28 -1 -1 28 -1 -1 28 -1 -1 28 -1 -1 28 -1 -1 28 6 -1 28 7 -1 28 5 -1 17 371 -1 17 -1 -1 17 -1 -1 28 4 -1 28 7 -1 28 8 -1 28 -1 -1 28 -1 -1 28 -1 -1 
28 -1 -1 28 328 -1 28 329 -1 28 330 -1 28 -1 -1 28 33 -1 28 -1 -1 28 -1 -1 28 -1 -1 28 35 -1 28 -1 -1 28 -1 -1 28 33 -1 28 -1 -1 28 9 -1 17 -1 -1 17 -1 -1 17 -1 -1 17 -1 -1 17 -1 -1 17 -1 -1 17 -1 -1 28 11 -1 28 -1 -1 28 -1 -1 28 -1 -1 
28 35 -1 28 -1 -1 28 -1 332 348 347 -1 28 349 -1 28 350 -1 28 -1 334 28 -1 -1 28 -1 282 28 -1 285 28 -1 288 28 -1 -1 28 -1 -1 28 34 -1 28 12 -1 28 13 -1 28 13 -1 28 13 -1 28 13 -1 28 13 -1 28 13 -1 28 13 -1 28 14 -1 28 -1 -1 28 -1 -1 28 -1 -1 
28 -1 -1 28 34 -1 28 -1 335 352 369 -1 28 353 -1 28 354 -1 28 -1 337 28 -1 -1 28 -1 283 28 -1 286 28 -1 289 28 -1 -1 28 -1 291 28 -1 294 28 -1 297 28 35 -1 28 -1 -1 28 -1 -1 28 -1 -1 28 -1 -1 28 -1 -1 28 -1 -1 28 -1 -1 28 -1 -1 28 -1 -1 28 34 -1 
28 -1 -1 28 -1 -1 28 -1 338 28 -1 339 28 -1 339 28 -1 339 28 -1 340 28 -1 -1 28 -1 284 28 331 287 28 -1 290 28 -1 -1 28 -1 292 28 -1 295 28 -1 298 28 -1 -1 129 -1 -1 130 -1 -1 130 -1 -1 130 -1 -1 131 -1 -1 28 -1 -1 28 122 -1 28 -1 -1 28 -1 -1 28 35 -1 
28 33 -1 28 -1 -1 28 360 -1 361 372 -1 28 361 -1 28 361 -1 28 362 -1 28 35 -1 28 322 -1 28 323 -1 28 324 -1 28 -1 -1 28 -1 293 28 331 296 28 -1 299 28 -1 -1 132 -1 -1 133 281 -1 133 281 -1 133 281 -1 134 -1 -1 28 -1 -1 28 -1 -1 28 33 -1 28 -1 -1 28 -1 -1 
28 -1 -1 28 -1 -1 28 363 -1 364 373 -1 28 364 -1 374 -1 -1 28 365 -1 102 209 211 28 328 -1 28 329 -1 28 330 -1 28 33 -1 28 322 -1 28 323 -1 28 324 -1 28 -1 -1 132 -1 -1 133 281 -1 133 281 -1 133 281 -1 134 -1 -1 28 -1 -1 28 33 -1 28 34 -1 28 -1 -1 28 34 -1 
28 -1 -1 28 -1 -1 28 366 -1 367 -1 -1 367 -1 -1 379 370 -1 28 368 -1 102 210 -1 28 -1 -1 28 -1 -1 28 34 -1 28 35 -1 35 -1 -1 28 329 -1 28 330 -1 28 -1 -1 135 -1 -1 136 -1 -1 136 -1 -1 136 -1 -1 137 -1 -1 28 -1 -1 28 -1 -1 28 -1 -1 28 -1 -1 28 -1 -1 
28 7 -1 28 7 -1 28 5 -1 17 -1 -1 17 -1 -1 17 371 -1 28 4 -1 28 7 -1 28 7 -1 28 7 -1 28 7 -1 28 7 -1 28 7 -1 28 7 -1 28 7 -1 28 7 -1 28 7 -1 28 7 -1 28 7 -1 28 7 -1 28 7 -1 28 7 -1 28 7 -1 28 7 -1 28 7 -1 28 7 -1 
10 -1 -1 10 -1 -1 10 3 -1 10 -1 -1 10 -1 -1 10 -1 -1 10 -1 -1 10 -1 -1 10 0 -1 10 3 -1 10 -1 -1 10 -1 -1 10 -1 -1 10 -1 -1 10 -1 -1 10 -1 -1 10 -1 -1 17 -1 -1 17 -1 -1 17 -1 -1 17 -1 -1 17 0 -1 17 -1 -1 17 -1 -1 17 -1 -1 17 -1 -1 
17 43 -1 17 43 -1 17 43 -1 17 43 -1 17 43 -1 17 43 -1 17 43 -1 17 43 -1 17 43 -1 17 43 -1 17 43 -1 17 43 -1 17 43 -1 17 43 -1 17 43 -1 17 43 -1 17 43 -1 17 43 -1 17 43 -1 17 43 -1 17 43 -1 17 43 -1 17 43 -1 17 43 -1 17 43 -1 17 43 -1 
