26 26
28 35 -1 28 102 -1 28 102 312 102 331 315 102 -1 318 102 -1 -1 102 45 -1 28 46 -1 28 46 -1 46 -1 -1 28 46 -1 28 47 -1 28 -1 -1 28 -1 280 364 28 -1 28 -1 -1 102 35 -1 28 9 -1 9 16 -1 11 16 -1 28 11 -1 28 -1 -1 28 -1 -1 28 -1 -1 28 -1 -1 28 -1 -1 
28 102 -1 28 -1 310 28 -1 313 102 331 316 102 -1 -1 102 39 -1 28 48 -1 28 38 -1 28 46 -1 46 -1 -1 28 37 -1 28 50 -1 28 -1 -1 28 -1 -1 367 28 310 28 -1 313 28 -1 316 28 9 -1 28 16 -1 28 16 -1 28 11 -1 28 -1 -1 28 -1 -1 28 33 -1 28 -1 -1 28 -1 -1 
35 -1 -1 28 -1 311 28 102 314 102 331 307 102 -1 -1 102 -1 -1 28 36 -1 28 48 -1 28 49 -1 28 49 -1 28 50 -1 102 85 -1 102 -1 -1 102 -1 -1 17 102 311 102 -1 314 102 -1 317 28 9 -1 28 16 -1 16 -1 -1 28 11 -1 28 68 -1 28 -1 -1 28 -1 -1 28 -1 -1 28 35 -1 
102 -1 -1 102 -1 312 102 331 315 102 331 318 102 -1 -1 102 277 -1 28 102 -1 28 102 -1 28 -1 -1 134 28 -1 28 -1 -1 102 -1 -1 102 -1 -1 102 -1 -1 102 -1 312 102 331 315 102 -1 318 28 9 -1 28 16 -1 8 16 -1 28 4 -1 28 7 -1 28 7 -1 28 7 -1 28 8 -1 28 -1 -1 
28 -1 -1 102 322 -1 102 323 -1 102 323 -1 102 324 -1 102 -1 -1 28 102 -1 28 -1 -1 28 -1 280 137 28 -1 28 35 -1 28 -1 -1 28 -1 279 102 -1 -1 102 -1 -1 102 331 -1 28 -1 -1 28 9 -1 28 16 -1 28 16 -1 28 16 -1 28 16 -1 16 -1 -1 28 16 -1 28 11 -1 28 -1 -1 
28 -1 -1 102 328 -1 102 329 -1 102 329 -1 102 330 -1 28 102 -1 28 -1 -1 28 -1 -1 28 -1 -1 28 -1 -1 28 -1 -1 28 -1 -1 102 -1 -1 102 -1 -1 102 319 -1 102 323 -1 102 321 -1 28 9 -1 28 16 -1 16 -1 -1 28 16 -1 28 16 -1 28 16 -1 28 16 -1 28 11 -1 28 -1 -1 
28 -1 -1 28 102 279 102 -1 -1 28 102 -1 28 102 -1 28 -1 -1 28 33 -1 28 -1 -1 28 -1 -1 28 34 -1 28 -1 -1 102 -1 -1 102 -1 -1 102 -1 -1 102 325 -1 102 329 -1 102 330 -1 28 12 -1 28 13 -1 28 13 -1 28 13 -1 28 2 -1 16 -1 -1 11 16 -1 28 11 -1 28 33 -1 
102 -1 -1 28 -1 -1 28 -1 -1 28 -1 310 28 -1 313 28 -1 316 28 -1 -1 28 -1 -1 28 -1 -1 28 -1 -1 28 -1 -1 102 -1 -1 102 -1 310 102 -1 313 102 -1 316 102 -1 -1 28 -1 -1 28 -1 -1 28 33 -1 28 68 -1 28 -1 -1 28 9 -1 16 -1 -1 16 -1 -1 28 11 -1 28 -1 -1 
28 -1 -1 28 34 -1 28 -1 -1 28 -1 311 28 331 314 28 34 307 28 -1 -1 28 -1 -1 102 -1 -1 102 -1 -1 28 102 -1 28 102 -1 28 102 311 102 -1 314 102 -1 317 102 -1 -1 28 -1 -1 28 -1 279 28 102 -1 28 102 -1 28 -1 -1 28 9 -1 28 16 -1 28 16 -1 28 11 -1 28 -1 -1 
28 -1 280 28 -1 -1 28 -1 -1 28 -1 312 28 331 315 28 -1 318 28 -1 -1 102 -1 -1 102 -1 -1 102 -1 -1 28 102 -1 28 34 -1 28 -1 312 102 331 315 102 -1 318 28 102 -1 28 277 -1 348 28 -1 102 -1 -1 28 -1 -1 28 -1 -1 28 9 -1 28 16 -1 28 16 -1 28 11 -1 28 -1 -1 
102 -1 -1 28 102 -1 28 -1 -1 28 319 -1 28 323 -1 102 321 -1 102 -1 -1 102 -1 -1 102 -1 280 102 -1 -1 102 -1 -1 28 -1 -1 28 34 -1 28 331 310 102 -1 313 102 -1 316 102 -1 310 102 -1 313 102 -1 316 28 -1 -1 28 -1 -1 28 9 -1 28 16 -1 16 -1 -1 28 11 -1 28 -1 -1 
102 -1 -1 28 102 -1 28 35 -1 28 325 -1 28 326 -1 102 327 -1 102 277 -1 102 -1 -1 102 -1 -1 102 -1 -1 102 -1 -1 28 -1 -1 28 -1 -1 102 331 311 28 102 314 102 -1 317 102 -1 311 102 -1 314 102 -1 317 28 -1 -1 28 -1 -1 28 9 -1 16 -1 -1 28 16 -1 28 11 -1 28 68 -1 
28 102 -1 28 275 -1 28 102 -1 28 -1 -1 28 -1 -1 102 -1 -1 102 -1 -1 102 -1 -1 102 -1 310 102 -1 313 102 -1 316 28 -1 -1 35 -1 -1 35 331 312 102 331 315 102 -1 318 102 -1 312 102 331 315 102 -1 318 28 -1 -1 28 -1 -1 28 9 -1 28 16 -1 16 -1 -1 28 11 -1 28 -1 -1 
28 102 -1 28 102 310 102 -1 313 28 -1 316 102 -1 -1 28 102 279 28 102 -1 102 -1 -1 102 -1 311 102 -1 314 102 -1 317 28 -1 -1 102 322 -1 102 320 -1 28 323 -1 102 321 -1 102 -1 -1 102 331 -1 102 -1 -1 28 -1 -1 28 -1 -1 28 9 -1 28 16 -1 28 16 -1 28 11 -1 28 35 -1 
28 102 -1 102 -1 311 102 331 314 28 102 307 28 -1 -1 28 102 -1 102 -1 -1 102 -1 -1 102 -1 312 102 331 315 28 102 318 28 -1 -1 102 328 -1 102 329 -1 102 329 -1 102 330 -1 102 322 -1 102 320 -1 28 324 -1 28 -1 -1 28 -1 -1 28 9 -1 28 16 -1 28 16 -1 28 11 -1 28 -1 -1 
102 -1 -1 102 -1 312 102 331 315 102 -1 318 28 102 -1 28 -1 -1 28 -1 -1 28 -1 -1 28 322 -1 28 323 -1 28 324 -1 28 -1 -1 102 -1 -1 102 -1 279 102 -1 -1 102 -1 -1 102 325 -1 102 326 -1 102 327 -1 17 28 -1 28 68 -1 28 9 -1 28 16 -1 28 16 -1 28 11 -1 28 -1 -1 
102 -1 -1 102 -1 -1 102 331 -1 102 -1 -1 102 -1 -1 273 102 -1 273 102 -1 273 102 -1 102 328 -1 102 329 -1 28 330 -1 28 -1 -1 28 33 -1 28 -1 -1 28 -1 -1 102 -1 -1 17 28 -1 28 -1 -1 28 -1 -1 17 28 -1 17 28 -1 28 9 -1 16 -1 -1 16 -1 -1 28 11 -1 28 -1 -1 
102 -1 -1 102 322 -1 102 323 -1 102 324 -1 102 -1 -1 102 -1 -1 102 -1 -1 102 -1 310 102 -1 313 273 102 316 102 -1 -1 28 -1 -1 28 -1 -1 28 34 -1 28 -1 -1 28 -1 -1 28 -1 -1 28 -1 -1 28 -1 -1 28 -1 -1 28 -1 -1 28 9 -1 28 16 -1 28 16 -1 28 11 -1 28 -1 -1 
28 -1 -1 102 328 -1 102 329 -1 102 330 -1 102 -1 310 102 -1 313 102 -1 316 273 102 311 273 102 314 273 102 307 102 -1 -1 28 -1 -1 28 -1 -1 28 -1 -1 28 -1 -1 28 35 -1 28 -1 -1 28 -1 -1 28 -1 -1 28 -1 -1 28 -1 -1 28 9 -1 28 16 -1 28 16 -1 28 11 -1 28 34 -1 
28 102 -1 28 102 -1 102 -1 -1 102 -1 -1 102 -1 311 102 -1 314 102 -1 307 102 -1 312 102 331 315 273 102 318 273 102 -1 28 -1 -1 28 -1 -1 28 -1 -1 28 -1 -1 28 -1 -1 129 28 -1 130 28 -1 28 -1 -1 28 -1 -1 131 28 -1 28 9 -1 28 16 -1 28 16 -1 28 11 -1 28 35 -1 
102 -1 -1 28 102 -1 102 -1 -1 102 -1 -1 102 -1 312 102 331 315 102 -1 318 102 319 -1 102 323 -1 102 321 -1 102 -1 -1 28 -1 -1 28 -1 -1 28 -1 -1 28 -1 -1 28 -1 -1 132 28 -1 28 -1 -1 28 35 -1 28 -1 -1 28 -1 -1 28 9 -1 28 16 -1 16 -1 -1 28 11 -1 28 -1 -1 
28 -1 -1 28 -1 -1 102 -1 -1 102 -1 -1 102 319 -1 34 320 -1 102 321 -1 102 328 -1 102 326 -1 102 327 -1 102 -1 -1 28 33 -1 28 -1 -1 28 -1 -1 28 -1 -1 28 -1 -1 28 -1 -1 28 35 -1 28 -1 -1 28 -1 -1 28 -1 -1 28 9 -1 16 -1 -1 16 -1 -1 28 11 -1 28 34 -1 
28 -1 -1 348 28 -1 102 -1 -1 367 102 -1 7 34 -1 34 326 -1 102 327 -1 102 -1 -1 28 -1 -1 28 -1 -1 28 34 -1 28 35 -1 28 -1 -1 28 -1 -1 28 -1 -1 28 -1 -1 135 28 -1 136 28 -1 136 28 -1 136 28 -1 28 -1 -1 28 9 -1 16 -1 -1 16 -1 -1 28 11 -1 28 -1 -1 
28 7 -1 28 7 -1 28 7 -1 34 7 -1 102 7 -1 102 7 -1 102 7 -1 28 7 -1 28 7 -1 28 7 -1 28 7 -1 28 7 -1 28 7 -1 28 7 -1 28 7 -1 28 7 -1 28 7 -1 28 7 -1 28 7 -1 28 7 -1 28 7 -1 28 5 -1 16 -1 -1 16 -1 -1 28 4 -1 28 7 -1 
10 -1 -1 10 -1 -1 10 3 -1 10 -1 -1 10 -1 -1 10 -1 -1 10 -1 -1 10 -1 -1 10 0 -1 10 3 -1 10 -1 -1 10 -1 -1 10 -1 -1 10 -1 -1 10 -1 -1 10 -1 -1 10 -1 -1 17 -1 -1 17 -1 -1 17 -1 -1 17 -1 -1 17 0 -1 17 16 -1 17 16 -1 17 -1 -1 17 -1 -1 
17 43 -1 17 43 -1 17 43 -1 17 43 -1 17 43 -1 17 43 -1 17 43 -1 17 43 -1 17 43 -1 17 43 -1 17 43 -1 17 43 -1 17 43 -1 17 43 -1 17 43 -1 17 43 -1 17 43 -1 17 43 -1 17 43 -1 17 43 -1 17 43 -1 17 43 -1 17 43 -1 17 43 -1 17 43 -1 17 43 -1 
